############################
#..P#......................#
#...####..##.###...........#
#......#..#...##...........#
#..#...####...##...........#
#..#...........#...........#
#..#...........#.#######...#
#..#................#......#
######..............#......#
#.....#....................#
#......###..######.........#
#......................G...#
############################